#################
#               #
# ## # ### # ## #
# ## #     # ## #
#    # # # #    #
# #### # # #### #
# #           # #
# # #### #### # #
#               #
# #### ### #### #
#      ###      #
# ## # ### # ## #
# ## #     # ## #
#    # # # #    #
# #### # # #### #
#               #
#################

